-1
10
11 11
 25  20  18  16  14  12  14  16  18  20  25
 20  19  15  13  11   9  11  13  15  19  20
 18  15  11   9   7   4   7   9  11  15  18
 16  13   9   6   4   3   4   6   9  13  16
 14  11   7   4   2   1   2   4   7  11  14
 12   9   4   3   1   0   1   3   4   9  12
 14  11   7   4   2   1   2   4   7  11  14
 16  13   9   6   4   3   4   6   9  13  16
 18  15  11   9   7   4   7   9  11  15  18
 20  19  15  13  11   9  11  13  15  19  20
 25  20  18  16  14  12  14  16  18  20  25
CENTRO  5 5