-1
10
10 12
  1   2   1   0   0   2   0   0   0   0
  1   1   0   0   0   0   0   1   0   0
  0   0  -1  -1  -1   0   1   2   1   0
  0   0  -1  -2  -1   1   1   2   0   0
  1   0  -1  -4  -1   0   2   3   1   2
  1   0  -1  -3  -1   1   3   4   2   3
  1   0   0  -2   0   0   3   4   4   3
  4   1   0  -1   0   0   2   4   3   0
  7   2   1   0   0   0   0   0   0   0
 10   4   4   1   0   0   0   0   0   1
 12  10   9   7   4   0   0   0   1   1 
 15  18  15  11   7   2   0   0   1   2
CASA   3   8
UIB  9 0