-1
1
10 10
  46   1   2   3   4   5   6   7   8   9   
 10  10  10  10  10  10  10  10  10  10  
 11  11  11  11  11  11  11  11  11  11  
 12  12  12  12  12  12  12  12  12  12  
 13  13  13  13  13  13  13  13  13  13  
 14  14  14  14  14  14  14  14  14  14  
 15  15  15  15  15  15  15  15  15  15  
 16  16  16  16  16  16  16  16  16  16  
 17  17  17  17  17  17  17  17  17  17  
 18  18  18  18  18  18  18  18  18  18  
PUTICLU  0 0 
