1
10
10 10
 18  18  17   3   0   2   5  12  15  18
 17  15  13   0   0   0   0   1  12  15
 14  11   7   2   0  -1   0   2   1  12
 11   7   3   0  -1  -2  -1   0   0   7
  7   5   2   0  -1  -4  -3   0   1   4
  4   3   1   0  -1  -3  -3   0   2   3
  2   1   0   3   0  -2   0   4   4   3
  4   1   0   3   0  -1   0   4   3   7
  5   2   1   0   2   0   0   0  12  15
 10   4   4   1   0   1   7  12  15  18
CASA  3 5
MERCADONA  1 1